11111  1
1      1
1 212  1
1  3   1
2  3   1
     3 1
1      1
11 12111