1111111111
11      11
11      11
111111  11
1        1
1        1
1        1
1        1
1        1
1111111111