1111111111
11      11
11 1111 11
11 1111 11
1        1
1        1
1        1
1        1
1        1
1111111111