1111111111
11111 1111
11111 1111
11111 1111
11111 1111
11111 1111
1        1
1        1
1        1
1111111111